1111111111
1000100011
1001000101
1000001001
1111111111